w w w w w w w w w w w w w w w w w
w f f f f f f f f f f f br f f f w
w f f bg f f f f f f f f f f f f w
w f f f f f f f f f f f f f f f w
w f f f f f f f f gg f f f f f f w
w f f gr f f f f f f f f f f f f w
w w f f f f f f f f f f f f f f w
w w w w w w w w w w w w w w w w w