w w w w w w w
w br f f f gr w
w f f f bg f w
w f f gg f f w
w w w w w w w